10,5,200
0,0,0,0,0,0,0,0,0,0
0,0,0,0,0,0,0,s,0,0
0,0,0,0,0,0,0,f,0,0
0,0,0,s,s,0,0,0,0,0
f,f,f,f,f,0,0,0,0,0

