50,27,38
f,0,0,0,0,0,0,0,0,0,0,0,0,0,0,0,0,0,0,0,f,s,s,s,s,s,s,s,f,s,0,0,0,0,0,0,0,0,0,0,0,0,0,0,0,0,0,0,0,f
f,0,0,0,0,0,0,0,0,0,0,0,0,0,0,0,0,0,0,0,f,s,0,0,0,0,0,0,f,s,0,0,0,0,0,0,0,0,0,0,0,0,0,f,0,0,0,0,0,f
f,0,0,0,0,0,0,0,0,0,0,0,0,0,0,0,0,0,0,0,f,s,0,0,0,0,0,0,f,0,0,0,f,0,0,0,0,0,0,0,0,0,0,f,0,0,0,0,0,f
f,0,0,0,0,0,0,0,0,0,0,0,0,0,0,0,0,0,0,0,f,s,0,f,f,s,0,0,f,0,0,f,f,0,s,0,0,0,0,0,0,0,0,f,0,0,0,0,0,f
f,0,0,0,0,0,0,0,0,0,0,0,0,0,0,0,0,0,0,0,f,s,0,0,f,s,0,f,f,0,0,0,f,0,f,f,f,0,0,0,0,0,0,0,0,0,0,0,0,f
f,f,f,f,f,f,0,0,0,0,0,0,0,0,0,0,0,0,0,0,0,0,0,0,f,s,0,0,0,0,0,0,f,0,0,0,0,0,0,s,s,s,0,0,0,0,0,0,0,f
f,0,0,0,0,0,0,0,0,0,0,0,0,0,0,0,0,c,0,0,0,0,0,0,f,s,0,0,0,0,s,s,f,s,0,0,0,s,f,f,f,f,f,f,f,f,f,f,f,f
f,k,0,0,0,0,0,0,0,0,0,0,0,0,0,0,f,f,f,f,f,f,f,f,f,f,f,f,f,f,f,f,f,f,f,f,f,f,f,0,0,0,0,0,0,0,0,0,0,f
f,f,f,f,f,f,f,f,f,f,f,f,f,0,0,0,0,0,0,0,0,0,0,0,0,0,0,0,0,0,0,0,0,0,0,0,0,0,0,0,0,0,0,0,0,0,0,0,0,f
f,0,0,0,0,0,0,0,0,0,0,0,0,0,0,f,f,0,0,0,0,0,0,0,0,0,0,0,0,0,0,0,0,0,0,0,0,0,0,0,0,0,0,0,c,0,0,0,0,f
f,0,0,0,0,0,0,0,0,0,0,0,0,0,0,0,0,0,f,f,f,f,0,0,0,0,0,0,0,0,0,0,0,0,0,0,0,0,0,0,0,0,0,f,f,0,0,0,0,f
f,0,0,0,0,0,0,0,0,0,0,0,0,0,0,0,0,0,0,0,0,f,f,f,f,f,f,f,0,0,0,0,0,0,0,0,0,0,0,s,s,0,0,0,f,0,0,0,0,f
f,0,0,0,0,0,0,0,0,0,0,0,0,0,0,0,0,0,0,0,0,0,0,0,0,0,0,0,0,0,0,0,0,0,0,0,0,0,f,f,f,f,0,0,f,0,0,f,f,f
f,0,0,0,0,0,0,0,0,0,0,0,0,0,0,0,0,0,0,0,0,0,0,0,0,0,0,0,0,0,0,0,0,0,0,0,0,0,0,0,0,0,0,0,f,0,0,0,0,f
f,0,0,0,0,0,0,0,0,0,0,0,0,0,0,0,0,0,0,0,0,0,0,0,0,0,0,0,0,0,0,0,0,0,0,0,0,0,0,0,0,0,0,0,f,0,0,0,0,f
f,0,0,0,0,0,0,0,0,0,0,0,0,0,0,0,0,0,0,0,0,0,0,0,0,0,0,0,0,0,0,0,0,0,0,0,0,0,0,0,0,0,0,0,f,0,0,0,0,f
f,S,0,0,0,0,0,0,0,0,0,0,0,0,0,0,0,0,0,0,0,0,0,0,0,0,c,0,0,0,0,0,0,0,0,0,0,0,0,0,0,0,0,0,0,f,f,0,0,f
f,f,f,f,f,f,0,0,0,f,f,f,f,0,0,0,0,f,f,f,f,0,0,0,0,f,f,f,f,0,0,0,0,0,0,0,0,0,0,0,s,0,0,0,0,f,0,0,0,f
f,0,0,0,0,0,0,0,0,0,0,0,0,0,0,0,0,0,0,0,0,0,0,0,0,0,0,0,f,f,f,s,s,0,0,0,0,0,0,0,f,0,0,0,0,f,0,0,0,f
f,0,0,0,0,0,0,0,0,0,0,0,0,0,0,0,f,f,f,0,0,0,0,0,0,0,0,0,0,0,f,f,f,0,0,0,0,0,0,0,f,0,0,0,0,f,0,0,0,f
f,0,0,0,0,0,s,s,s,0,0,0,0,0,0,0,0,0,0,0,0,0,0,0,0,0,0,0,0,0,0,0,f,f,f,f,0,0,0,f,f,f,0,0,f,f,f,0,0,f
f,0,0,0,0,0,f,f,f,f,f,f,f,f,0,0,0,0,0,0,0,0,0,0,0,0,0,0,0,0,0,0,0,0,0,0,0,0,0,0,0,0,0,0,0,0,0,0,0,f
f,0,0,0,0,0,0,0,0,0,0,0,0,f,0,0,0,0,0,0,0,0,0,0,0,0,0,0,0,0,0,0,0,0,0,0,0,0,0,0,0,0,0,0,0,0,0,0,0,f
f,f,f,f,0,0,0,0,0,0,0,0,k,f,0,0,0,0,0,0,0,0,0,0,0,0,0,0,0,0,0,0,0,0,0,0,0,0,0,0,0,0,0,0,0,0,f,f,f,f
f,0,0,0,0,0,0,0,f,f,f,f,f,f,0,0,0,0,0,0,0,0,0,0,0,0,0,0,0,0,0,0,0,0,0,0,0,0,0,0,0,0,0,0,0,0,0,0,0,f
f,s,s,s,s,s,s,s,s,s,s,s,s,s,s,s,s,s,s,s,s,s,s,s,s,s,s,s,s,s,s,s,s,s,s,s,s,s,s,s,s,s,s,s,s,s,s,s,s,f
f,f,f,f,f,f,f,f,f,f,f,f,f,f,f,f,f,f,f,f,f,f,f,f,f,f,f,f,f,f,f,f,f,f,f,f,f,f,f,f,f,f,f,f,f,f,f,f,f,f