20,10,100
RF,RA,RA,RA,RA,RA,RA,RA,RA,RA,RA,RA,RA,RA,RA,RA,RA,RA,RA,RF
RF,RA,RA,RA,RA,RA,RA,RA,RA,RA,RA,RA,RA,RA,RA,RA,RA,RA,RA,RF
RF,RA,RA,RA,RA,RA,RA,RA,RA,RA,RA,RA,RA,RA,RA,RA,RA,RA,RA,RF
RF,RA,RA,RA,RA,RA,RA,RA,RA,RA,RA,RA,RA,RA,RA,RA,RA,RA,RA,RF
RF,RA,RA,RA,RA,RA,RA,RA,RA,RA,RA,RA,RA,RA,RA,RA,RA,RA,RA,RF
RF,RA,RA,RA,RA,RA,RA,RA,RA,RA,RA,RA,RA,RA,RA,RA,RA,RA,RA,RF
RF,RA,RA,RA,RA,RA,RT,RA,RA,RT,RA,RA,RT,RA,RA,RA,RA,RA,RA,RF
RF,RA,RDU,RA,RA,RA,RA,RA,RA,RA,RA,RC,RC,RC,RC,RC,RA,RA,RA,RF
RF,RA,RDD,RA,RA,RA,RA,RA,RA,eR,RA,RC,RF,RC,RTT,RC,RS,RA,RA,RF
RF,RF,RF,RF,RF,RF,RF,RF,RF,RF,RF,RF,RF,RF,RF,RF,RF,RF,RF,RF