19,10,100
0,0,0,0,0,0,0,0,0,0,0,0,0,0,0,0,0,0,0
0,0,0,0,0,0,0,0,0,0,0,0,0,0,0,0,0,0,0
0,0,0,0,0,0,0,0,0,0,0,0,0,0,0,0,0,0,0
0,0,0,0,0,0,0,0,0,0,0,0,0,0,0,0,0,0,0
0,0,0,0,0,0,0,0,f,f,f,f,f,0,0,0,0,0,0
0,0,0,0,0,0,0,0,0,0,0,0,0,0,0,0,0,0,0
0,0,0,0,f,f,0,0,0,0,0,0,0,0,0,0,0,0,0
0,S,0,0,0,0,0,0,0,0,0,0,0,0,0,0,0,0,E
0,0,0,0,0,0,0,0,s,s,s,s,s,0,0,0,0,0,E
f,f,f,f,f,f,f,f,f,f,f,f,f,f,f,f,f,f,f