20,10,100
f,0,0,0,0,0,0,0,0,0,0,0,0,0,0,0,0,0,0,f
f,0,0,0,0,0,0,0,0,0,0,0,0,0,0,0,0,0,0,f
f,0,0,0,0,0,0,0,0,0,0,0,0,0,0,0,0,0,0,f
f,0,0,0,0,0,0,0,0,0,0,0,0,0,0,0,0,0,0,f
f,0,0,0,0,0,0,0,0,0,0,0,0,0,0,0,0,0,0,f
f,0,0,0,0,0,0,0,0,0,0,0,0,0,0,0,0,0,0,f
f,0,0,0,0,0,0,0,0,0,0,0,0,0,0,0,0,0,0,f
f,0,0,0,0,0,0,0,0,0,0,0,0,0,0,0,0,0,E,f
f,S,0,0,f,f,sU,sU,sU,sU,sU,sU,sU,sU,f,f,0,0,E,f
f,f,f,f,f,f,f,f,f,f,f,f,f,f,f,f,f,f,f,f