20,10,100
f,f,f,f,f,f,f,f,f,f,f,f,f,f,f,f,f,f,f,f
f,0,0,0,0,0,0,0,0,0,0,0,0,0,0,0,0,0,0,f
f,0,0,0,0,0,0,0,0,0,0,0,0,0,0,0,0,0,EU,f
f,0,0,0,0,0,0,0,0,0,0,0,0,0,0,0,0,0,ED,f
f,0,0,0,0,0,0,0,0,0,0,0,0,0,0,0,f,f,f,f
f,0,0,0,0,0,0,0,f,f,f,0,0,0,0,0,0,0,0,f
f,0,0,0,0,0,0,0,0,0,0,0,0,f,f,0,0,0,0,f
f,0,0,0,f,f,f,0,0,0,0,0,0,0,0,0,0,0,0,f
f,0,S,0,0,0,0,0,0,sU,sU,sU,0,0,0,0,0,0,0,f
f,f,f,f,f,f,f,f,f,f,f,f,f,f,f,f,f,f,f,f
