20,10
0,0,0,0,0,0,0,0,0,0,0,0,0,0,0,0,0,0,0,0
f,f,0,0,0,0,0,0,0,0,0,0,0,0,0,0,0,0,0,0
0,f,0,0,0,f,0,0,f,f,f,0,0,0,0,0,0,0,0,0
0,0,0,f,f,f,0,0,0,0,0,0,0,0,0,0,0,0,0,0
0,0,0,0,0,0,0,0,0,0,0,0,0,0,0,0,0,0,0,0
f,f,f,0,0,0,0,0,0,0,0,0,0,0,0,0,0,0,0,0
0,0,0,0,0,0,f,0,0,0,0,0,0,0,0,0,0,0,0,0
0,0,0,0,0,0,f,0,0,0,0,0,0,0,0,0,0,0,E,E
0,0,0,0,0,f,f,0,0,0,0,0,0,0,0,0,0,0,E,E
f,f,f,f,f,f,f,f,f,f,f,f,f,f,f,f,f,f,f,f
